..............................
...#.................###......
...#..........................
...#..........................
...........#.........#........
............#.........#.......
..........###.......###.......
..............................
..............................
..............................
